bg: ['hobgoblin', 'hobgoblins', 'subgroup', 'subgroups']
bk: ['lambkin', 'lambkins']
bp: ['subplot', 'subplots', 'subpoena', 'subpoenaed', 'subpoenaing', 'subpoenas', 'subprime', 'subprogram', 'subprograms']
bw: ['bobwhite', 'bobwhites', 'cobweb', 'cobwebs', 'dumbwaiter', 'dumbwaiters', 'subway', 'subways']
cd: ['anecdota', 'anecdotal', 'anecdote', 'anecdotes']
cm: ['acme', 'acmes', 'blancmange']
cn: ['acne', 'picnic', 'picnicked', 'picnicker', 'picnickers', 'picnicking', 'picnics']
cz: ['czar', 'czarina', 'czarinas', 'czars', 'eczema']
dk: ['bodkin', 'bodkins', 'handkerchief', 'handkerchiefs', 'handkerchieves', 'roadkill', 'vodka']
dq: ['headquarter', 'headquarters', 'hindquarter', 'hindquarters']
dz: ['adze', 'adzes', 'kudzu', 'kudzus']
fc: ['briefcase', 'briefcases']
fd: ['serfdom']
fg: ['afghan', 'afghans']
fh: ['cliffhanger', 'cliffhangers', 'halfhearted', 'halfheartedly', 'halfheartedness', 'offhand', 'offhandedly', 'wolfhound', 'wolfhounds']
fj: ['fjord', 'fjords']
fn: ['aloofness', 'briefness', 'deafness', 'gruffness', 'hafnium', 'stiffness']
fp: ['halfpence', 'halfpennies', 'halfpenny']
fw: ['halfway']
gc: ['dogcatcher', 'dogcatchers']
gd: ['hangdog', 'kingdom', 'kingdoms', 'wrongdoer', 'wrongdoers', 'wrongdoing', 'wrongdoings']
gj: ['logjam', 'logjams']
gk: ['gingko', 'gingkoes', 'gingkos']
gz: ['zigzag', 'zigzagged', 'zigzagging', 'zigzags']
hg: ['churchgoer', 'churchgoers', 'flashgun', 'flashguns', 'thoroughgoing']
hj: ['highjack', 'highjacked', 'highjacker', 'highjackers', 'highjacking', 'highjacks', 'mahjong']
hk: ['babushka', 'babushkas']
hq: ['earthquake', 'earthquakes']
kc: ['blackcurrant', 'bookcase', 'bookcases', 'crankcase', 'crankcases', 'sackcloth']
kg: ['backgammon', 'background', 'backgrounds', 'blackguard', 'blackguards', 'ginkgo', 'ginkgoes', 'ginkgos']
kj: ['blackjack', 'blackjacked', 'blackjacking', 'blackjacks', 'lockjaw']
lj: ['killjoy', 'killjoys']
lq: ['catafalque', 'catafalques', 'milquetoast', 'milquetoasts']
lz: ['schmalz', 'schmalzy']
md: ['gumdrop', 'gumdrops', 'humdinger', 'humdingers', 'humdrum', 'slumdog', 'slumdogs']
mh: ['armhole', 'armholes', 'farmhand', 'farmhands', 'farmhouse', 'farmhouses', 'warmhearted', 'wormhole', 'wormholes']
mq: ['cumquat', 'cumquats', 'kumquat', 'kumquats']
mt: ['daydreamt', 'warmth']
mv: ['circumvent', 'circumvented', 'circumventing', 'circumvention', 'circumvents', 'triumvirate', 'triumvirates']
mw: ['bantamweight', 'bantamweights', 'dimwit', 'dimwits', 'dimwitted', 'firmware', 'teamwork', 'wormwood']
pj: ['flapjack', 'flapjacks']
rz: ['furze', 'marzipan', 'overzealous', 'scherzi', 'scherzo', 'scherzos']
sv: ['svelte', 'svelter', 'sveltest', 'transverse', 'transversely', 'transverses', 'transvestism', 'transvestite', 'transvestites']
tj: ['straightjacket', 'straightjacketed', 'straightjacketing', 'straightjackets', 'straitjacket', 'straitjacketed', 'straitjacketing', 'straitjackets']
tk: ['catkin', 'catkins', 'hotkey', 'hotkeys', 'pocketknife', 'pocketknives']
tv: ['outvote', 'outvoted', 'outvotes', 'outvoting']
uh: ['brouhaha', 'brouhahas']
uj: ['hallelujah', 'hallelujahs', 'jiujitsu', 'jujitsu', 'jujube', 'jujubes', 'jujutsu']
uq: ['bouquet', 'bouquets']
uu: ['continuum', 'continuums', 'muumuu', 'muumuus', 'vacuum', 'vacuumed', 'vacuuming', 'vacuums']
uw: ['thruway', 'thruways']
vr: ['chevron', 'chevrons', 'louvred', 'outmanoeuvre', 'outmanoeuvred', 'outmanoeuvres', 'outmanoeuvring']
wc: ['newcomer', 'newcomers', 'pillowcase', 'pillowcases', 'showcase', 'showcased', 'showcases', 'showcasing']
ww: ['glowworm', 'glowworms', 'powwow', 'powwowed', 'powwowing', 'powwows']
wz: ['blowzier', 'blowziest', 'blowzy', 'frowzier', 'frowziest', 'frowzy']
xb: ['oxbow', 'oxbows']
xf: ['oxford', 'oxfords']
xg: ['foxglove', 'foxgloves']
xl: ['axle', 'axles', 'laxly', 'sexless']
xn: ['laxness']
xq: ['exquisite', 'exquisitely']
xs: ['coxswain', 'coxswains']
xw: ['boxwood', 'waxwing', 'waxwings', 'waxwork', 'waxworks']
yj: ['skyjack', 'skyjacked', 'skyjacker', 'skyjackers', 'skyjacking', 'skyjacks']
yk: ['dyke', 'dykes', 'shaykh', 'shaykhs', 'tyke', 'tykes']
zk: ['buzzkill', 'buzzkills']
zm: ['gizmo', 'gizmos', 'hazmat']
zp: ['chutzpa', 'gazpacho', 'hutzpa', 'hutzpah']
zv: ['rendezvous', 'rendezvoused', 'rendezvouses', 'rendezvousing']
zw: ['buzzword', 'buzzwords', 'zwieback']